11111111111111111111
10010000000C00000001
10000111110000000001
100011E0000000000001
10000110000000000001
1P0011E0000000000001
11111111111111111111