1111111111111111111111111111111
1000100C101000000000C0110000011
10001000000C0111100011110000001
1001000000001010001010010100001
101CP1000100100110011C010001011
1100010010C01001010000101001011
101C0010000CC000000110C00001011
1100000010101001CC10001000010C1
110000C0000010C1000000100001001
1E0C011011100011001C11010110001
1111111111111111111111111111111